13 13 4 3
+++++.@.+++++
++++#.#.#++++
++#+++#+++#++
+++++++++++++
+#++++#++++#+
..++++#++++..
@#+++++++++#@
..+++###+++..
+#++++#++++#+
+++#+++++#+++
++#+++#+++#++
++++#.#.#++++
+++++.@.+++++
