11 11 4 3
+++++++++++
+#+++#+++#+
+++++++++++
+++#.#.#+++
+++.@#@.+++
+#+#####+#+
+++.@#@.+++
+++#.#.#+++
+++++++++++
+#+++#+++#+
+++++++++++ 