15 10 4 4
@..++..#..++..@
..#+++++++++#..
..#+++++++++#..
+##++##+##++##+
+##++##+##++##+
+##++##+##++##+
+##++##+##++##+
..#+++++++++#..
..#+++++++++#..
@..++..#..++..@ 