10 10 4 3
..........
#.+....+.#
#..+.+.+.#
#.++..++.#
#..+..++.#
@++.+.+.+#
@.+.+.+.+#
@.....#+..
@..++###..
...++.#+.. 